XXXXXXXXXXXXXXXXXXXXXXXXXXXXXXXXXXXXXXXXXXXXXXXXX
P X         X       X     X           X         X
X X X XXXXX X XXXXX X X X X XXXXXXX X X XXX XXX X
X   X X   X X     X X X X X X X   X X     X X X X
X XXX X X XXXXXXX X X X XXX X X X XXXXXXXXX X X X
X X X   X         X   X     X X X           X X X
X X XXXXXXXXXXXXXXXXXXXXX XXX X XXXXXXXXXXXXX X X
X   X   X       X       X   X X X     X     X   X
XXX X X X XXXXX X XXXXX XXX X X XXXXX X X X X XXX
X X   X X X       X   X   X   X     X X X X X   X
X XXXXX X X XXXXXXX XXXXX XXXXXXXXX X X X X XXX X
X       X X X     X   X   X     X   X   X X X X X
XXXXXXXXX X X XXX X X X XXX XXX X XXX XXX X X X X
X         X X X   X X X X   X X X   X   X X   X X
X XXXXX XXXXX X XXX X X X X X X XXX XXX X X XXX X
X X     X   X X X X X   X X X X     X   X X X   X
X XXXXXXX X X X X X XXXXXXX X XXXXXXX XXX X X XXX
X X       X   X X X     X   X   X     X X X X   X
X X XXXXXXXXXXX X XXXXX X XXX X X XXXXX X XXXXX X
X X     X   X   X   X   X X X X X   X   X     X X
X XXXXX XXX X XXX X X XXX X X X XXX X X XXX XXX X
X X   X     X X   X X X   X   X   X   X X X     X
X X X XXX XXX X X XXX X XXX XXX XXXXXXX X XXXXXXX
X X X   X X   X X     X X   X X       X       X X
X X XXX X X XXX XXXXXXX XXX X XXXXXXX XXXXXXX X X
X X X X   X X X X     X   X X     X   X     X X X
X X X XXXXX X X X XXXXX X X XXXXX X X X XXX X X X
X X X   X X X X X   X   X X   X   X X X   X   X X
X X X X X X X X X X X XXX XXX X XXX XXXXX XXXXX X
X X   X   X X X X X   X   X   X   X     X X     X
X XXXXX XXX X X X XXXXX XXX XXXXX XXXXX X X XXX X
X       X X X   X     X   X         X   X X   X X
XXXXXXXXX X X XXXXXXX XXX XXXXXXXXX X XXX XXX X X
X       X   X     X   X X     X   X X     X   X X
XXXXX X XXXXXXXXX X XXX XXXXX X X X XXXXXXXXXXX X
X   X X   X       X X   X   X X X         X     X
X X XXXXX X XXXXXXX X X XXX X XXXXXXXXXXX X XXXXX
X X X     X X   X     X X   X       X     X     X
X X X XXX X X X XXXXXXX X XXXXXXXXX X XXXXXXXXX X
X X   X   X   X   X       X   X     X         X X
X XXXXX XXXXXXXXX XXXXX XXX X X XXX XXXXXXXXX X X
X   X     X     X     X X   X X   X X   X   X X X
XXX X XXXXX XXX XXXXX X X XXX XXX XXX X X X X X X
X   X X   X   X   X   X X X     X     X X X X   X
X X XXX X XXX XXX X XXX X XXXXX XXX XXX X X XXX X
X X X   X   X X   X   X X     X   X   X   X X X X
X XXX XXX XXX X XXXXX XXXXXXX XXX XXXXXXXXX X X X
X       X     X               X             X   K
XXXXXXXXXXXXXXXXXXXXXXXXXXXXXXXXXXXXXXXXXXXXXXXXX